000000000000000
022222202222220
020200202002020
022220626022220
020022202220020
022220222022220
002000020000500
002002222200200
002000020000200
002202222202200
000202222202000
000200020002000
000222020222000
000002020200000
023222252222220
020200000002020
022222202222220
000000222000000
000000202000000
000000000000000